##########
#*.*.*B*.#
#.B.B.B..#
#........#
#...P....#
#........#
##########